1111111111111
1000000E001C1
1010101111101
1001111100001
10001C01001P1
1000110000C11
111C000000111
1111111111111